#    #    #
 #  #.#  #
  ##..###
  #1....#
 #.......#
#....=....#
 #.......#
  #....2#
  ###..##
 #  #.#  #
#    #    #
*Mini Rhombas
*Par 6