    ###
    #.#
   #...#
  #1....#
##.......##
#....=....#
##.......##
  #....2#
   #...#
    #.#
    ###