#############
#.....A.....#
#...B###B...#
#..#.....#..#
#1.#..=..#.2#
#..#.....#..#
#...B###B...#
#...........#
#############