#############
#......A....#
#...B###B...#
#..#.....#..#
#1.#..=..#.2#
#..#.....#..#
#...B###B...#
#....A......#
#############
*Donjon
*Par 10