#############
#......A....#
#...B###B...#
#..#..B..#..#
#1.#B.=.B#.2#
#..#..B..#..#
#...B###B...#
#....A......#
#############
*Donjon
*Par 14