#############
#.....A.....#
#....###....#
#..#.....#..#
#1.B..=..B.2#
#..#.....#..#
#....###....#
#.....A.....#
#############