#############
#...........#
#....###....#
#..#.....#..#
#1.#..=..#.2#
#..#A...A#..#
#....###....#
#....B.B....#
#############