##############
#.........B..#
#....####....#
#..#....#.#..#
#1.#.#=#..#.2#
#..#.A...A#..#
#....##.#....#
#.......B....#
##############
*Inner Chamber
*Par 8