    ###########
    #.........###
 ####.#######...#
 #.A......###...#
 #........###...#
##........####..#
#1........2#=..##
##........####..#
 #........###...#
 #....B...###...#
 ###.########...#
   #..........###
   ############
*Circuit Breaker
*Par 17