     ###
  ####1####
  #.......#
###......A#
#.........###
#.#.........#
#.#B......#.#
#.#.......#.#
#.#.......#.#
#.#.......#.#
#.####2####.#
#.#########.#
#.####=####.#
#....#.#....#
##.........##
 #....#....#
 ###########