    ###########
    #.........###
 ####.#######...#
 #.B......###...#
 #........###...#
##........####..#
#1.....A..2#=..##
##........####..#
 #........###...#
 #....B...###...#
 ###.########...#
   #..........###
   ############
*Circuit Breaker
*Par 22