          #####
          #...#
          #.1.#
          #...#
          #...#
###########...######
#................B.#
#A.=A....B.........#
#...........B......#
################...#
               #...#
               #...#
               #.2.#
               #...#
               #####
*Hexomino #1