###############
#.......#A#...#
#.1.........2.#
#.............#
#######B#A#B###
     ##.###.########
     #..B.B........#
     #..........=..#
     #...#.........#
     ###############
*Hexomino #21 of 35
*Par 13