############
#.1.2......#
#.....#....#
#...#....A.#
#.......#..#
#....A#B####
#######....#######
      #..........#
      #........#.#
      #....=.....#
      #..........#
      #.......#..#
      ############
*Tetris Z
*Par 13