############
#.1.2......#
#.....#....#
#...#....A.#
#.......#..#
#....A#B####
#######....#######
      #..........#
      #........B.#
      #....=.....#
      #..........#
      #.......B..#
      ############
*Tetris Z
*Par 13