###############
#.......#A#...#
#.1.........2.#
#.............#
#######B#A#B###
     ##.###.########
     #.A...A.......#
     #.......A..=..#
     #..##.........#
     ###############
*Hexomino #21 of 35
*Par 19