######           ######
#....#   ####    #....#
#...######..######...##
#........&..&.........#
#....######B######....#
###.##    #.#    ###.##
  #.#     #.#      #.#  
  #.#     #A###    #.# 
  #.#     #...#    #.# 
###.##    #.=.#  ###.##
#1#..#    #...#  #2#..#
#....#############....#
#....&&A&&&B&&&A&&...##
#..#.##############...#
#....#           #....#
######           ######