#####
#...#
#.=.#
#...#
#B..#
###.######
#.#...#..#
#........#
#......B.#
#.A......#
#........######
#.....B.......#
#.1.........2.#
#...........A.#
###############
*Hexomino #32 of 35
*Par 13