#####     #####
#...#     #...#
#.1.#     #.2.#
#...#     #...#
#...#     #...#
#...#######...#
#......B......#
#.A.........A.#
#.............#
######...######
     #...#    
     #...#
     #...#
     #.=.#
     #####
*Hexomino #4
*Par 6