     ############
     #..1....2..#
     #..........#
     ####....####
        #....#
#########....#######
#.......#..........#
#...#...#.....A....#
#...##..#..........#
#A.##.=.#..........#
#...#...##.........#
#...#####..........#
#...A..B..#....#...#
####################