#######           #######
#.....#   ####    #.....#
#....######..######....##
#.........&..&..........#
#.........&..&..........#
#.....######B######.....#
###..##    #.#    ###..##
  #..#     #.#      #..#  
  #..#     #A###    #..# 
  #..#     #...#    #..# 
###..##    #.=.#  ###..##
#1#...#    #...#  #2#...#
#.....#############.....#
#.....&&A&&&B&&&A&&....##
#..#..##############....#
#.....#           #.....#
#######           #######
*Castle
*Par 32