     ###########
     #......1..#
     #.........#
     ###.....###
       #.....#
########.....########
#...................#
#...................#
#.........=.........#
#...................#
#...................#
########.....########
       #.....#
     ###.....###
     #.........#
     #..2......#
     ###########
