       #######
       #....1#
       #.....#
       #.....#
       #.....#
       #.....#
########.....########
#...................#
#...................#
#.........=.........#
#...................#
#...................#
########.....########
       #.....#
       #.....#
       #.....#
       #.....#
       #2....#
       #######
