        ############
#########..........#
#1...............B.#
#..#.##.#.###.##.#.#
#..#...............#
#..#.##.#####.##.#.##
#..#......=......#..#
##.#.##.#####.##.#..#
 #...............#..#
 #.#.##.###.#.##.#..#
 #.A...............2#
 #..........#########
 ############