     ###
     #.#
    #...#
   #1....#
  #...A...#
##.........##
#..B..=..B..#
##.........##
  #...A...#
   #....2#
    #...#
     #.#
     ###