      #
     #.#
    #...#
   #1.A..#
  #.......#
 #.........#
#...B.=.B...#
 #.........#
  #.......#
   #..A.2#
    #...#
     #.#
      #
*Rhombus
*Par 8