        ############
#########..........#
#1.............A...#
#..#.##.#.###.##.#.#
#..#...............#
#..#.##.##B##.##.#.##
#..#......=......#..#
##.#.##.##B##.##.#..#
 #...............#..#
 #.#.##.###.#.##.#..#
 #...A.............2#
 #..........#########
 ############
*Dot Dash
*Par 25