#################
#....B.....A....#
#.....#...#.....#
#....###=###....#
#...##.###.##...#
#..###########..#
#..#.#######.#..#
#..#.#1...2#.#..#
#.....##.##.....#
#...............#
#################
*Space Invader
*Par 15