        ############
#########..........#
#1.................#
#..#.##.#.###.##.#.#
#..#........A......#
#..#.##.##.##.##.#.##
#..#......=......#..#
##.#.##.##.##.##.#..#
 #......B.......B#..#
 #.#.##.###.#.##.#..#
 #.................2#
 #...A......#########
 ############
*Dot Dash
*Par 25