#########
#1.....A#
#.BBBBB.#
#.BAAAB.#
#.BA=AB.#
#.BAAAB.#
#.BBBBB.#
#......2#
#########