         # 
        #.#
       #.A.#
  #####..#..#####
  #.....# #.....#
  #.##.#   #.##.#
  #..#..# #..#..#
  #..#...#...#..#
 #..# #...A.# #..#
#1.#   #.=.#   #.2#
 #..# #.A...# #..#
  #..#...#...#..#
  #..#..# #..#..#
  #.##.#   #.##.#
  #.....# #.....#
  #####..#..#####
       #.A.#
        #.#
         #
*Celtic Knot