#####################
#..&.&.&...&&...&&&.#
#&.&.1&...&...&..&&.#
#.&&..&&.&&&..&.&..&#
#..&.&...&.&...&....#
#..&&&.&....&.A.&&..#
#.&&&&.&..B....&....#
#..&&....AA...&..&..#
#...&&&.BA=AB....&&&#
#&&.&.&...AA...&&..&#
#..&.&.&..B......&&&#
#&..&..&....&.&&&&..#
#..&&..B.....&..&..&#
#&..&.....&&...&&..&#
#&....&&....&.&.&&..#
#.&&..&..&&..&.&.&.&#
#&&&..&...&&..&2&&.&#
#####################