#####################
#1.&.&.&...&&...&&&.#
#&.&.&&.#####.&..&&.#
#.&&..&&#   #.&.&..&#
#..&.&..#   #..&....#
#..&&&.&#####.A.&&..#
#...&..&..B....&....#
#.#####..AA...#####.#
#.#   #.BA=AB.#   #&#
#&#   #...AA..#   #&#
#.#####&..B...#####&#
#&..&..&....&.&&&&..#
#..&&..B#####&..&..&#
#&..&...#   #..&&..&#
#&....&&#   #.&.&&..#
#.&&..&.#####&.&.&.&#
#&&&..&...&&..&.&&.2#
#####################
*Enigma
*Par 8