   ###########################
   #.........................#
####.########.#####.########.####
##.............................##
 #.#.#####.###########.#####.#.#
 #.#.#.....#...1B2...#.....#.#.#
 #.#.#.#.#.#.#######.#.#.#.#.#.#
 #.#.#.#.#.#.#.....#.#.#.#.#.#.#
 #.#...#.....##.=.##.....#...#.#
 #.#.##########B#B##########.#.#
##.............................##
####.##########...##########.####
   #...........A.............#
   ###########################
   ##                       ##