#####################
#....1#2........#...#
#.#.#.###.#####.#.#A#
#...#...#...#...#...#
###.###.###.#.#####.#
#...#.#...#.#.#...#.#
#.#.#.###.#.#.#.#.#.#
#.#.....#.......#.#.#
#.#B###.###.###.#.#.#
#.#.#.......#.......#
#.###.#.###.#.#######
#...#.#...#...#.....#
#.#.#.###.#.###.###.#
#.#.#.#.....#.....#=#
#.#.#.#.#########.#.#
#.A.........A.#...#.#
#.#########.###.#.#.#
#....#.......#..#.#.#
##.....#..#.....#...#
#####################