#####################
#....1#2..A....&&&B.#
#.#.#.###.#####.#.#.#
#A..#...#...#...#...#
##B####.###.#.#####B#
#...#.#...#.#.#...#.#
#.#.#B###.#B#.#.#.#.#
#.#...#A#.....#.#.#.#
#.#.###.###B###.#A#.#
#.#.#...BB..#...B...#
#.###.#.###.#.#######
#...#.#...#...#..BA.#
#.#.#.###.#.###.###.#
#.#.#.#A#...#&....#=#
###.#.#A#########.#.#
#.....#.....B.#...#.#
#.#########.###.#.#A#
#.A..#....B..#..#.A.#
##B....#..#.....#A#A#
#####################