#####################
#....1...2......#...#
#.#.#.###.#####.#.#B#
#...#...#...#...#...#
###.#.#.###.#.#####.#
#...#.#...#.#.#...#.#
#.###.###.#.#.#.#.#.#
#.#...#.#.......#.#.#
#A#.###.###.###.#.#.#
#.#.#.......#.......#
#.###.#.###.#.#######
#...#.#...#...#.....#
#.#.#.###.#A###.###.#
#.#.#.#.....#.....#=#
#.#.#.#.#########.#.#
#.............#...#.#
#.#########.###.#.#.#
#....#.......#..#.#.#
##.....#..#..B..#...#
#####################
*Super Maze
*Par 14