10, 10
          #################
          #......#........#
          #...............#
          #..#####.#####..#
          #..#   #.#   #..#
          #..#   #.#   #..#
          #..#   #.#   #..#
          #..#   #=#   #..#
          #..#   ###   #..#
          #..#         #..#
          #..#         #..#
###########..###########..###########
#...................................#
#...................................#
#..########..###########..########..#
#..#      #..#         #..#      #..#
#..#      #..#         #..#      #..#
#..#      #..#         #..#      #..#
#..#      #..#         #..#      #..#
#..#      #..#         #..#      #.2#
#1.#      #..#         #..#      #..#
#..#      #..#         #..#      #..#
#..#      #..#         #..#      #..#
#..#      #..#         #..#      #..#
#..#      #..#         #..#      #..#
#..########..###########..########..#
#...................................#
#...................................#
###########..###########..###########
          #..#         #..#
          #..#         #..#
          #..#         #..#
          #..#         #..#
          #..#         #..#
          #..#         #..#
          #..###########..#
          #...............#
          #...............#
          #################