######           ######
#....#           #....#
#...##############...##
#........&...&........#
#....######.######....#
###.##    #.#    ###.##
###.##  ###B###  ###.## 
  #.#   #..&..#    #.# 
  #.#   ##.&.##    #.# 
###.##  #..#.=#  ###.##
#1#..#  #.....#  #2#..#
#....#############....#
#....&&&&&&A&&&&&&...##
#..#.##############...#
#....#           #....#
######           ######