######           ######
#....#           #....#
#...##############...##
#.......&......&......#
#....######.######....#
###.##    #.#    ###.##
###.##  ###&###  ###.## 
  #.#   #..&..#    #.# 
  #.#   ##.&.##    #.# 
###.##  #..#.=#  ###.##
#1#..#  #.....#  #2#..#
#....#############....#
#....&&&&&&&&&&&&&....#
#..#.##############...#
#....#           #....#
######           ######