    ###########
######........###############
#...........................#
#.####.#######.############.#
#.####.#=....#.#.......####.#
#.####.................####.#
#.####.#######.#######.####.#
#.####.#######.#######.####.#
#.####.##..###.###..##.####.#
#.####.##.1..#.#....##.####.#
#.####.###.#.#.#.#.###.####.#
#..##...##.#.....#.###.####.#
#..........#.#.#.#.##...##..#
#..##...##..................#
#.####.###.#.#.#.#.##...##..#
#.####.###.#.....#.###.####.#
#.####.###.#.#.#.#.###.####.#
#.####.##....#.#..2.##.####.#
#.####.##..###.###..##.####.#
#.####.#######.#######.####.#
#.####..######.######..####.#
#...........................#
######.#######.#######.######
     #.................#
     ###################