    ###########
######........###############
#...........................#
#.####.#######.############.#
#.#  #.#=....#.#.......#  #.#
#.#  #.................#  #.#
#.#  #.#######.#######.#  #.#
#.#  #.##### #.# #####.#  #.#
#.#  #.##..###.###..##.#  #.#
#.#  #.##.1..#.#....##.#  #.#
#.####.###.#.#.#.#.###.#  #.#
#..##...##.#.....#.###.####.#
#.....B....#.#.#.#A##...##..#
#..##...##............B.....#
#.####.###A#.#.#.#.##...##..#
#.#  #.###.#.....#.###.####.#
#.#  #.###.#.#.#.#.###.#  #.#
#.#  #.##....#.#..2.##.#  #.#
#.#  #.##..###.###..##.#  #.#
#.#  #.##### #.# #####.#  #.#
#.####..######.######..####.#
#...........................#
######.#.####...####.#.######
     #...#  #...#  #...#
     #####  #####  #####