     ###########
     #..1......#
     #.........#
     ###.....###
       #.....#
########.....########
#...................#
#...................#
#.........=.........#
#...................#
#...................#
########.....########
       #.....#
     ###.....###
     #.........#
     #......2..#
     ###########
