        ############
#########..........#
#1.................#
#..#.##.#.###.##.#.#
#..#...............#
#..#.##.#####.##.#.##
#..#......=......#..#
##.#.##.#####.##.#..#
 #...............#..#
 #.#.##.###.#.##.#..#
 #.................2#
 #..........#########
 ############