#####################
#..&.&.&...&&...&&&.#
#&.&.2&...&...&..&&.#
#.&&..&&.&&&..&.&..&#
#..&.&...&.&...&....#
#..&&&.&....&.A.&&..#
#.&&&&.&..B....&....#
#..&&....AA...&..&..#
#...&&&.BA=AB....&&&#
#&&.&.&...AA...&&..&#
#..&.&.&..B......&&&#
#&..&..&....&.&&&&..#
#..&&..B.....&..&..&#
#&..&.....&&...&&..&#
#&....&&....&.&.&&..#
#.&&..&..&&..&.&.&.&#
#&&&..&...&&..&1&&.&#
#####################