#########
#2.....A#
#.BBBBB.#
#.BAAAB.#
#.BA=AB.#
#.BAAAB.#
#.BBBBB.#
#......1#
#########