20, 20
#######################################
#.....................................#
#.###################################.#
#.#.................................#.#
#.#.###############################.#.#
#.#.#.............................#.#.#
#.#.#.###########################.#.#.#
#.#.#.#...#.....1#2.....#...#...#.#.#.#
#.#.#.#.#.#.###########.#.#.#.#.#.#.#.#
#.#.#.#.#.#.#.........#.#.#.#.#.#.#.#.#
#.#.#.#.#.#.#......=..#.#.#.#.#.#.#.#.#
#.#.#...#...##.......##...#...#.#.#.#.#
#.#.############...############.#.#.#.#
#.#.............................#.#.#.#
#.##############...##############.#.#.#
#.................................#.#.#
################...################.#.#
#.....................................#
#######################################
