#############
#...........#
#....###....#
#..#.....#..#
#1.#..=..#.2#
#..#.....#..#
#....###....#
#...........#
#############
