15
########################
#..........#...........#
##...##...###......#..1#
#...........##..#......#
#......................#
#.....................##
#..................=...#
#......................#
#...........#........###
#......................#
###..#......##..#......#
#...#......##.........2#
#......................#
########################
