#######################################
#.....................................#
#.################################.##.#
#.#.................................#.#
#.#.######################.########.#.#
#.#.#.............................#.#.#
#.#.#.###################.#######.#.#.#
#.#.#.#...#.....1#2.....#...#...#.#.#.#
#.#.#.#.#.#.###########.#.#.#.#.#.#.#.#
#.#.#.#.#.#.#.........#.#.#.#.#.#.#.#.#
#.#.#.#.#.#.#......=..#.#.#.#.#.#.#.#.#
#.#.....#...##.......##...#...#.#.#.#.#
#.#.############...############.#.#.#.#
#.#.............................#.#.#.#
#.##############...##############.#.#.#
#.................................#.#.#
##.#############...################.#.#
#.....................................#
#######################################