     ###
     #1#
  ####.####
  #.......#
###.......#
#.........###
#.#.........#
#.#.......#.#
#.#.......#.#
#.#.......#.#
#.#.......#.#
#.####2####.#
#.#  ###  #.#
#.####=####.#
#....#.#....#
##.........##
 #....#....#
 ###########
