     #
    #.#
   #...#
  #1....#
 #......&#
#....=....#
 #.......#
  #....2#
   #...#
    #.#
     #
