     #
    #.#
   #...#
  #1....#
 #...&...#
#...&=&...#
 #...&...#
  #....2#
   #...#
    #.#
     #
