###########################
###......................##
#.........................#
#...#........#............#
#.....................#...#
#........#................#
#...............#.........#
#1....#......=......#....2#
#.........#...............#
#................#........#
#...........#.........#...#
#............#.......#....#
#....#.................#..#
##......................###
###########################