###########################
##.......................##
#..#......................#
#............#............#
#.....................#...#
#........#................#
#...............#.........#
#1....#......=......#....2#
#.........#...............#
#.........................#
#................#........#
#...#.....................#
#............#............#
#......................#..#
##.......................##
###########################
