#####################
#A#...#12.A....&&&B.#
#.#.#.###.#####.#.#.#
#A..#...#...#...#...#
##B####.###.#.#####B#
#...#.#...#.#.#...#.#
#.#.#B###.#B#.#.#.#.#
#.#...#A#.....#.#.#.#
#.#.###A###B###.#A#.#
#.#.#...BB#.#...B...#
#.###.#.###.#.#######
#...#.#...#...#..BA.#
#A#.#.###.#.###.###.#
#.#.#.#A#...#&....#=#
###.#.#A#########.#.#
#.....#.....B.#...#.#
#.#########.###.#.#A#
#A........B.....#.A.#
##B##############A#A#
#........&&&&&....B.#
#####################