20, 20
######           ######
#2...#           #....#
#...##############....#
#.......&......&......#
#....######.######....#
###.##    #.#    ###.##
###.##  ###.###  ###.## 
  #.#   #.....#    #.# 
  #.#   ##...##    #.# 
###.##  #....=#  ###.##
#.#..#  #.....#  #....#
#....#############....#
#.........&&&.........#
#....##############...#
#....#           #...1#
######           ######
