50
########################
#......................#
##.........##.........1#
#...........##..#......#
#......................#
#.....................##
#..................==..#
#..................==..#
#.....................##
#......................#
#...........##..#......#
##.........##.........2#
#......................#
########################